ig.module( 'game.levels.' )
.requires( 'impact.image' )
.defines(function(){
LevelLevels.=/*JSON[*/{
	"entities": [],
	"layer": [
		{
			"name": "new_layer_0",
			"width": 50,
			"height": 20,
			"linkWithCollision": false,
			"visible": true,
			"tilesetName": "media/tiles_spritesheet.png",
			"repeat": false,
			"preRender": false,
			"distance": "1",
			"tilesize": 72,
			"foreground": false,
			"data": [
				[0,0,0,0,0,0,0,0,0,0,0,0,0,0,0,0,0,0,0,0,0,0,0,0,0,0,0,0,0,0,0,0,0,0,0,0,0,0,0,0,0,0,0,0,0,0,0,0,0,0],
				[0,0,0,0,0,0,0,0,0,0,0,0,0,0,0,0,0,0,0,0,0,0,0,0,0,0,0,0,0,0,0,0,0,0,0,0,0,0,0,0,0,0,0,0,0,0,0,0,0,0],
				[0,0,0,0,0,0,0,0,0,0,0,0,0,0,0,0,0,0,0,0,0,0,0,0,0,0,0,0,0,0,0,0,0,0,0,0,0,0,0,0,0,0,0,0,0,0,0,0,0,0],
				[0,0,0,0,0,0,0,0,0,0,0,0,0,0,0,0,0,0,0,0,0,0,0,0,0,0,0,0,0,0,0,0,0,0,0,0,0,0,0,0,0,0,0,0,0,0,0,0,0,0],
				[0,0,0,0,0,0,0,0,0,0,0,0,0,0,0,0,0,0,0,0,0,0,0,0,0,0,0,0,0,0,0,0,0,0,0,0,0,0,0,0,0,0,4,4,0,0,0,0,0,0],
				[0,0,0,0,0,0,0,0,0,0,0,0,0,0,0,0,0,0,0,0,0,0,0,0,0,0,0,0,0,0,0,0,0,0,0,0,0,0,0,0,0,0,0,0,0,0,0,0,0,0],
				[0,0,0,0,0,0,0,0,0,0,0,0,0,0,0,0,0,0,0,0,0,0,0,0,0,0,0,0,0,0,0,0,0,0,0,0,0,4,4,4,0,0,0,0,0,0,0,0,0,0],
				[0,0,0,0,0,0,0,0,0,0,0,0,0,0,0,0,0,0,0,0,0,0,0,0,0,0,0,0,0,0,0,0,0,0,0,0,0,0,0,0,0,0,0,0,0,0,0,0,0,0],
				[0,0,0,0,0,0,0,0,0,0,0,0,0,0,0,0,0,0,0,0,0,0,0,0,0,0,0,0,0,0,0,0,4,4,4,0,0,0,0,0,0,0,0,0,0,0,0,0,0,0],
				[0,0,0,0,0,0,0,0,0,0,0,0,0,0,0,0,0,0,0,0,0,0,0,0,0,0,0,0,0,0,0,0,0,0,0,0,0,0,0,0,0,0,0,0,0,0,0,0,0,0],
				[0,75,0,0,0,0,0,0,0,0,0,0,0,0,0,0,0,0,0,0,0,0,0,35,112,112,112,112,0,0,0,0,0,0,0,0,0,0,0,0,0,0,0,0,0,0,0,0,0,0],
				[0,88,0,44,0,0,0,0,0,0,0,0,0,0,0,0,0,0,0,0,0,0,35,22,165,165,165,165,112,0,0,0,0,0,0,0,0,0,0,0,0,0,0,0,0,0,0,0,0,0],
				[112,112,112,112,112,112,112,99,0,0,0,0,0,0,0,0,0,0,0,0,0,35,22,165,165,165,165,165,165,112,0,0,0,0,0,0,0,0,112,112,112,112,112,112,112,112,112,112,112,112],
				[165,165,165,165,165,0,0,0,0,0,0,0,0,0,0,0,0,0,0,0,35,22,165,165,165,165,165,165,165,165,112,112,112,112,112,112,112,112,165,165,165,165,165,165,165,165,165,165,165,165],
				[165,165,165,165,165,0,0,0,0,0,0,0,0,0,0,0,0,139,112,112,22,165,165,165,165,165,165,165,165,165,165,165,165,165,165,165,165,165,165,165,165,165,165,165,165,165,165,165,165,165],
				[165,165,165,165,165,165,112,112,112,112,112,112,113,0,0,0,0,0,165,165,165,165,165,165,165,165,165,165,165,165,165,165,165,165,165,165,165,165,165,165,165,165,165,165,165,165,165,165,165,165],
				[165,165,165,165,165,165,165,165,165,165,0,0,0,0,0,0,0,0,112,112,112,112,112,165,165,165,165,165,165,165,165,165,165,165,165,165,165,165,165,165,165,165,165,165,165,165,165,165,165,165],
				[165,165,165,165,165,165,165,165,165,165,111,111,111,111,111,111,111,111,165,165,165,165,165,165,165,165,165,165,165,165,165,165,165,112,112,112,112,165,165,165,165,165,165,165,165,165,165,165,165,165],
				[165,165,165,165,165,165,165,165,165,165,47,47,47,47,47,47,47,47,165,165,165,165,165,165,165,165,165,165,165,165,165,165,165,165,165,165,165,165,165,165,165,165,165,165,165,165,165,165,165,165],
				[165,165,165,165,165,165,165,165,165,165,47,47,47,47,47,47,47,47,165,165,165,165,165,165,165,165,165,165,165,165,165,165,165,165,165,165,165,165,165,165,165,165,165,165,165,165,165,165,165,165]
			]
		}
	]
}/*]JSON*/;
LevelLevels.Resources=[new ig.Image('media/tiles_spritesheet.png')];
});